NO ./asset/textures/perso_n.xpm
SO ./asset/textures/test_bloc.xpm
EA ./asset/textures/test_bloc2.xpm
WE ./asset/textures/perso_n.xpm
F 255,192,203
C 139,69,19

1111111111
1000000001
1000S00001
1000000001
1111111111
