NO ./asset/textures/perso_n.xpm
SO ./asset/textures/test_bloc.xpm
EA ./asset/textures/test_bloc2.xpm
WE ./asset/textures/perso_n.xpm
F 255,0,0
C 0,255,0

1111111111
1000000001
1000E00001
1000000001
1111111111
