NO ./oui.xpm
SO ./oui.xpm
WE ./oui.xpm
EA ./oui.xpm
C 255,255,255
F 255,255,255
1111111111111111111111
1000000000000000000001
1000000000000000000001
1000000000000000000001
1000000000000000000001
1000000000000000000001
1000000000000000000001
1000000000000000000001
1000000000000000000001
1000000000N00000000001
1111111111111111111111