NO ./asset/textures/test_bloc.xpm
SO ./asset/textures/perso_n.xpm
EA ./asset/textures/test_bloc2.xpm
WE ./asset/textures/test_bloc.xpm
F 0,0,0
C 255,255,255

111111111111111
100000000000001
101111111111101
101000000000101
101000W00000101
101000000000101
101111111111101
100000000000001
111111111111111
