NO ./asset/textures/test_bloc.xpm
SO ./asset/textures/test_bloc2.xpm
EA ./asset/textures/perso_n.xpm
WE ./asset/textures/test_bloc.xpm
F 34,139,34
C 255,20,147

1111111111111111111111111
1000000000000000000000001
1001111100000000111110001
1001000100000000100010001
1001000E00000000000010001
1001000100000000100010001
1001111100000000111110001
1000000000000000000000001
1111111111111111111111111
