NO ./asset/textures/perso_n.xpm
SO ./asset/textures/test_bloc.xpm
EA ./asset/textures/test_bloc2.xpm
WE ./asset/textures/perso_n.xpm
F 100,149,237
C 184,134,11

11111111111111111111111111111
10000000000000000000000000001
10000000000000000000000000001
10000011111111111111110000001
10000010000000000000010000001
10000010000000S00000010000001
10000010000000000000010000001
10000011111111111111110000001
10000000000000000000000000001
10000000000000000000000000001
11111111111111111111111111111
