NO ./asset/textures/minecraft/deepslate_gold_ore.xpm
SO ./asset/textures/minecraft/deepslate_gold_ore.xpm
WE ./asset/textures/minecraft/deepslate_gold_ore.xpm
EA ./asset/textures/minecraft/deepslate_gold_ore.xpm
F 255,255,255
C 42,42,42


    11
   1001
  100001
 10000001
1000000001
1000000001
 100000001111111111111111111111
10000000000000000000000000001
100E0000000001000000000000001
10000000000000000000000000001
 100000001111111111111111111111
 100000001111111111111111111111
  10000000000000000000000000001
   1000000000001000000000000001
  10000000000000000000000000001
 100000001111111111111111111111
10000000001111111111111111111111
1000000000000000000000000000001
100000000000001000000000000001
1000000000000000000000000000001
10000000001111111111111111111111
10000000001
10000000001
1000000001
100000001
111111111