NO ./asset/textures/minecraft/deepslate_diamond_ore.xpm
SO ./asset/textures/minecraft/deepslate_diamond_ore.xpm
WE ./asset/textures/minecraft/deepslate_diamond_ore.xpm
EA ./asset/textures/minecraft/deepslate_diamond_ore.xpm
F 127,255,255
C 77,184,230

    11
   1001
  100001
 10000001
1000000001
1000000001
 10000000111111111111111111111        1
  10000000000000000000000000001    1 1  1   1
   100000000000100000000000000011 1       1      11
  10000000000000000000000000001  1 1           1
 1000000E1111111111111111111111       1  1  1
1000000001
100000001
 10000001
  100001
   1001
    11