NO ./asset/textures/minecraft/destroy/destroy_stage_1.xpm
SO ./asset/textures/test_bloc1.xpm
WE ./asset/textures/test_bloc1.xpm
EA ./asset/textures/test_bloc1.xpm
F 155,155,42
C 15,58,255


    11
   1001
  100001
 10000001
1000000001
1000000001
 10000000111111111111111111111        1
  10000000000000000000000000001    1 1  1   1
   10E000000000100000000000000011 1       1      11
  10000000000000000000000000001  1 1           1
 100000001111111111111111111111       1  1  1
1000000001
100000001
 10000001
  100001
   1001
    11