NO ./asset/textures/ebini.xpm
SO ./asset/textures/ebini.xpm
WE ./asset/textures/ebini.xpm
EA ./asset/textures/ebini.xpm
F 85,156,20
C 77,184,230

000111000000000111000
001111110000011111100
011000111000111000110
110000011001100000011
110000011001100000011
110000000000000000011
110001100000001100011
011001111000111110110
001111111111111111100
000111111111111111000
000011111111111110000
000001111N11111100000
000000111111111000000
000001100000001100000
000011000000000110000
000110000000000011000
001100000000000001100
011000000000000000110
