NO ./asset/textures/ebini.xpm
SO ./asset/textures/ebini.xpm
WE ./asset/textures/ebini.xpm
EA ./asset/textures/ebini.xpm
F 220,100,0
C 225,30,0
                     1111
       1             1001
1     101         1  1001
1111111011111111110111001
1000000000000000000000011
1000100000000000000000001
1111111111111111111111101
    1000000000000000000N1
    111111111111111111111
