NO ./asset/textures/test_bloc.xpm
SO ./asset/textures/test_bloc.xpm
WE ./asset/textures/test_bloc.xpm
EA ./asset/textures/test_bloc.xpm
F 220,100,0
C 225,30,0
                     1111
                     1001
1     0              1001
1111111111111111111111001
1000000000000000000000011
100N100000000000000000001
1111111111111111111111101
    100000000000000000001
    111111111111111111111
    1