NO ./asset/textures/minecraft/deepslate_diamond_ore.xpm
SO ./asset/textures/minecraft/diamond_ore.xpm
WE ./asset/textures/minecraft/diamond_block.xpm
EA ./asset/textures/ebini.xpm
F 220,100,100
C 225,30,100

111111111111111111111111111111111111111111111111111
101110111111011111111111101111111111100000011111101
100110111111011111111111001111111111100000100000001
110000111111000000111111011111111111100000111100011
111100011111111100000000011111111111110000111100001
111111011111111100000000011111111111000000111100001
100000011111111111111000011111111111111100111110001
111111011111111111111100011111111111111110000000111
100000011111111111111000000000000000000001111100001
110000000000000000000011111111111111111111100000011
111111111111111000000000111111111111111110000000111
100000000000000001111111111111100000000000111100001
111111100000000000001111000111100000011111111100001
111111100N00110000001111000011110000001111111100011
111111111111111111111111111111111111111111111111111
