NO ./asset/textures/ebini.xpm
SO ./asset/textures/ebini.xpm
WE ./asset/textures/ebini.xpm
EA ./asset/textures/ebini.xpm
F 155,155,42
C 15,58,255


11111111111
10000000001
10000S00001
10000000001
10000100001
10000000001
11111111111