NO ./asset/textures/test_bloc.xpm
SO ./asset/textures/test_bloc.xpm
WE ./asset/textures/test_bloc.xpm
EA ./asset/textures/test_bloc.xpm
F 255,100,0
C 225,30,0


11111111111
10000S00001
10000000001
10000000001
10000000001
10000000001
11111111111