NO ./asset/textures/minecraft/deepslate_diamond_ore.xpm
SO ./asset/textures/minecraft/deepslate_diamond_ore.xpm
WE ./asset/textures/minecraft/deepslate_diamond_ore.xpm
EA ./asset/textures/minecraft/deepslate_diamond_ore.xpm
F 85,156,20
C 77,184,230

1111111111111111111111
1000000000000000000001
1000000000000000000001
1000000000000000000001
1000000000000000000001
1000000000000000000001
1000000000000000000001
1000000000000000000001
1000000000000000000001
1000000000N00000000001
1111111111111111111111