NO ./path_to_the_north_texture
SO ./path_to_the_south_texture
WE ./path_to_the_west_texture
EA ./path_to_the_east_texture
F 220,100,0
C 225,30,0
1111111111111111111111111
1         11            1
1 11     111            1
1  1                    1
111111111 11     111    1
        1         11    1111111111111
        1111 111111111 111      1   1
        1111 111111111 111 1 1  1   1
        11      11 1 1 111      1   1
        1               11      1   1
        1                  1 1      1
        11     111 1 1 11111 1111 N 1
        1  1 1 1 1 1 1 1 1 1111 1   1
        11111111 1111111 111111111111