NO ./path_to_the_north_texture
SO ./path_to_the_south_texture
WE ./path_to_the_west_texture
EA ./path_to_the_east_texture
F 220,100,0
C 225,30,0


1111111111111111111111
1111011111111101110001
1111011111111101110101
1100000011010101110001
1000000000000000110001
1000000000000000000101
1100N00111010101111101
10010101 1010101 10111
11111111 1111111 11111