NO ./path_to_the_north_texture
SO ./path_to_the_south_texture
EA ./path_to_the_east_texture
WE ./path_to_the_west_texture
F 220,100,0
C 225,30,0

1111111111111111111111111
10000000N0110000000000001
1011000001110000000000001
1001000000000000000000001
1111111111111111111111111