NO ./asset/textures/test_bloc.xpm
SO ./asset/textures/test_bloc.xpm
WE ./asset/textures/test_bloc.xpm
EA ./asset/textures/test_bloc.xpm
F 220,100,0
C 225,30,0
1111111111111111111111111
1000000000110000000000001
1011000001110000000000001
1001000000000000000000001
1111111110110000011100001
        10001000001100001111111111111
        11110111111111011100000010001
        11110111111111011101010010001
        11000000110101011100000010001
        10000000000000001100000010001
        10000000000000000001010000001
        11000001110101011111011110001
        1001N101010101010101111010001
        11111111011111110111111111111