NO ./asset/textures/minecraft/deepslate_diamond_ore.xpm
SO ./asset/textures/minecraft/deepslate_emerald_ore.xpm
WE ./asset/textures/minecraft/deepslate_redstone_ore.xpm
EA ./asset/textures/minecraft/diamond_block.xpm
F 155,155,42
C 15,58,255


    11
   1001
  100001
 10000001
1000000001
1000000001
 1000000111111111111111111111111111111111111111111111111
  1000011100000000000000000000000000000000000000000000001
   10S0000000000000000000000000000000000000000000000000001
  1000011100000000000000000000000000000000000000000000001
 1000000111111111111111111111111111111111111111111111111
100000001
100000001
 10000001
  100001
   1001
    11
