NO ./asset/textures/test_bloc.xpm
SO ./asset/textures/test_bloc.xpm
WE ./asset/textures/test_bloc.xpm
EA ./asset/textures/test_bloc.xpm
F 220,100,0
C 225,30,0

11111111111
10110000001
10110000001
10110000001
10110010001
10110101001
10110000001
1000N000001
11111111111