NO ./asset/textures/test_bloc.xpm
SO ./asset/textures/test_bloc.xpm
WE ./asset/textures/test_bloc.xpm
EA ./asset/textures/test_bloc.xpm
F 255,100,0
C 225,30,0


11111111111
10000S00001
10000000001
10000000001
10000000001
10000000001
10000000001
10000100001
10000000001
10000000001
10000000001
10000100001
10000000001
10000000001
10000000001
10000100001
10000000001
10000000001
10000000001
10000000001
10000000001
10000000001
10000000001
10000000001
10000100001
10000000001
10000000001
10000001111
10000011111
10000111111
10001111111
10011111111
10111111111
11111111111