NO ./asset/textures/forza.xpm
SO ./asset/textures/4k/windows_4k.xpm
WE ./asset/textures/4k/light_4k.xpm
EA ./asset/textures/minecraft/diamond_block.xpm
F 000,100,0
C 225,30,0
11111111111
10000000001
1
1
1
1
1
11
1
11111111111
10000000001
10111010001
10001001001
100110N1001
11111111111