NO ./asset/textures/perso_n.xpm
SO ./asset/textures/test_bloc.xpm
EA ./asset/textures/test_bloc2.xpm
WE ./asset/textures/perso_n.xpm
F 220,100,0
C 25,25,112

1111111111111111111111
1000000000000000000001
